10
10

**********
**********
**********
**********
**********
**********
*****----*
**********
**p*******
----------