10
10

**********
**********
**********
**********
**********
*******d**
*****----*
**********
*b**p***l*
----------